3 14 2 2 2 2 2 2 2 2 2 2 2 2 2 2 2 2 2 4
5 0 0 18 1 0 1 0 1 18 1 0 1 1 1 0 1 0 16 6
5 0 0 0 1 0 11 10 11 0 1 0 1 0 1 0 1 0 1 6
5 0 1 0 1 0 1 11 1 18 1 0 1 0 1 11 17 0 1 6
5 0 1 0 1 0 1 0 1 0 1 0 1 0 1 0 1 0 1 6
5 0 16 0 1 0 17 0 1 0 16 0 1 0 1 0 17 0 1 6
5 0 1 0 1 0 1 0 0 0 1 0 1 17 1 0 1 10 1 6
5 18 1 0 17 0 1 0 1 18 1 10 1 0 1 0 1 18 1 6
5 0 1 0 1 0 10 11 1 0 1 0 1 1 1 0 1 0 1 6
5 0 1 0 1 0 1 0 1 18 1 0 1 0 1 0 1 1 1 6
7 9 9 9 9 9 9 9 9 9 9 9 9 9 9 9 9 9 9 8

